1111111111111111111111111111
1000N1001000C00001000N100001
1E0010000000000C00000C000001
1010010100100000101001000001
101P010010101010001001000001
10000N0000C0110000000N110001
100000000C00C000000000000001
1111111111111111111111111111