1111111111111
1010C11P01101
10000C0110011
1001000000101
1001001011001
100N001001011
11000000N0001
11010C0000101
10C0000000E01
1011010001001
100N011100011
1001000N11C01
1111111111111