111111111111
101N011011P1
10000C011001
11001000E001
101000100101
111000000N11
10C101100001
100N00010101
100000100C01
100N00C00111
101C00100001
111111111111